Tercer Nivel
7,7
5,4,4,0,0,0,0
2,6,4,0,0,0,0
3,2,6,2,0,0,0
3,6,4,0,0,0,0
3,0,4,0,0,0,0
2,2,6,2,0,0,0
6,0,4,0,0,0,0
6,2,4,0,0,0,0
0,5,4,0,0,0,0
4,2,6,1,0,0,0
5,1,3,0,0,0,255
0,3,4,0,0,0,0
1,0,4,0,0,0,0
4,0,4,0,0,0,0
0,1,4,0,0,0,0
2,3,6,2,0,0,0
3,3,1,0,0,0,0
2,0,4,0,0,0,0
4,1,2,0,0,0,255
6,1,4,0,0,0,0
2,4,6,2,0,0,0
6,3,4,0,0,0,0
1,5,4,0,0,0,0
5,0,4,0,0,0,0
0,4,4,0,0,0,0
4,5,4,0,0,0,0
1,6,4,0,0,0,0
3,4,6,0,0,0,0
0,2,4,0,0,0,0
