Adelante
3,10
1,0,4,0,0,0,0
2,1,4,0,0,0,0
2,3,4,0,0,0,0
1,8,3,0,0,0,0
0,7,4,0,0,0,0
2,8,4,0,0,0,0
0,3,4,0,0,0,0
0,8,4,0,0,0,0
0,6,4,0,0,0,0
0,2,4,0,0,0,0
2,6,4,0,0,0,0
0,5,4,0,0,0,0
2,2,4,0,0,0,0
1,5,2,0,0,0,0
2,4,4,0,0,0,0
0,1,4,0,0,0,0
0,4,4,0,0,0,0
2,5,4,0,0,0,0
1,1,1,0,0,0,0
2,7,4,0,0,0,0
1,9,4,0,0,0,0
